_SDCSR = ShippingDetails.CalculatedShippingRate
_SDSSO = ShippingDetails.ShippingServiceOptions
_SDISSO = ShippingDetails.InternationalShippingServiceOption
_VPVSPS = Variations.Pictures.VariationSpecificPictureSet
_VV0VSNVL = Variations.Variation.0.VariationSpecifics.NameValueList
Account = アカウント
Active = 出品中
Add = 追加
AddEtsyAccount = Add Etsy account
AddMoreVariation = Add more variation
AddNewItem = 新規商品作成
AdditionalCheckoutInstructions = Additional checkout instructions
AddeBayAccount = eBayアカウントを追加する
AddYourOwnDetail = Add your own detail
AddVariationDetail = Add variation detail
All = 全て
AllItems = 全ての商品
AutoPay = Auto Pay
AutoRelist = 自動再出品
BestOffer = Best offer
BestOfferAutoAcceptPrice = Best Offer Auto Accept Price
Blog = ブログ
BuyerGuaranteePrice = Buyer Guarantee Price
BuyerRequirements = Buyer Requirements
BuyItNowPrice = 即売価格
Cancel = キャンセル
Category = カテゴリ
CategoryAndTitle = カテゴリとタイトル
CheckAll = 全て
CheckAllPage = All pages
Close = 閉じる
Copy = コピー
Condition = 商品の状態
ConditionDescription = 商品の状態(説明文)
ConfirmPassword = パスワード(再入力)
Cost = Cost
Country = 国
Currency = 通貨
CustomLabel = Custom label
Delete = 削除
DemoAccount = デモアカウント
Description = 説明
Detail = 詳細
DevelopmentTimeline = 開発タイムライン
Dimensions = Dimensions
eBayListingSoftware = eBay出品ツール
Edit = 編集
Email = メールアドレス
End = 終了
Features = このツールの機能
Feedback = お問い合わせ
Forum = フォーラム
HandlingTime = Handling time
Help = ヘルプ
HitCounter = Hit Counter
Images = 写真
Import = インポート
ItemID = 商品ID
ItemSpecifics = Item Specifics
List = 出品
ListingDesigner = Listing Designer
ListingDuration = Listing Duration
ListingType = 出品タイプ
LoadingItemData = 商品データを読み込み中です ...
Loading = Loading2
Location = 場所
LotSize = Lot Size
Messages = メッセージ
MinimumBestOfferPrice = Minimum Best Offer Price
Notice = ご注意
Now = 現在
Options = オプション
Other = その他
PackageType = Package type
Password = パスワード
Payment = Payment
PaymentMethods = 支払い方法
Pict = 写真
Pictures = 写真
PostalCode = 郵便番号
Price = 価格
PrivateListing = Private Listing
ProductDetails = Product Details
Products = 製品
Quantity = 個数
Relist = 再出品
Respond = 返信する
ReturnPolicy = 返品ポリシー
Revise = 編集
SalesTax = Sales Tax
Saved = 保存済み
Save = 保存する
Schedule = スケジュール
Scheduled = 出品予約中
Screenshot = スクリーンショット
Search = 検索
SelectDesign = デザインを選択
SelectTheme = テーマを選択
Send = 送信
SendPasswordResetMail = パスワード再設定のメールを送信
Services = サービス
Setting = 設定
Settings = 設定
Shipping = 発送方法
ShippingType = 発送種別
ShipTo = Ship to
ShipToLocations = 発送先地域
SignIn = ログイン
SignOut = ログアウト
SignUp = ユーザ登録
Site = サイト
Sold = 落札あり
StartPrice = 開始価格
SubTitle = サブタイトル
Title = タイトル
Trash = ごみ箱
TryDemoAccount = デモを試してみる
Unanswered = 未回答
UncheckAll = クリア
Unsold = 落札なし
UserID = ユーザID
UPC = UPC
Variations = バリエーション
VariationSpecificPictureSet = バリエーション別の写真
VariationSpecificsSet = Variation specifics set
Verify = エラーチェック
Weight = 重量
